9.ox
...o..o...oo..oo..
o.......o..o.o....
...oo.oo..........
..o....o.o..o..o..
......o....o.oo..o
.......oooo.o.....
.......o...o...o..
...oo........o....
o.o.....o.......o.
